TTTTTTTTTTTTTTT
TTT............
TT.............
T..............
T..............
T..............
T..............
T..............
T....TTTTTT....
T....TTTTT.....
T....TTT.......
T..............
T..............
T..............
T..............