TTTTTTTTTTTTTTTTTTTTTTTTTTTTTTTTTTTTTTTTTTTTTTTTTTTTTTTTTTTTTTTTTTTTTTTTTTTTTTTTTTTTTTTTTTTTTTTTTTTT
TTT............TT..................................................TT.TTT...TTTT.TTTT............TTT
TT...............................................................TTT........TTT..TTT.............TTT
T..................................................................................................T
T..................................................................................................T
T..................................................................................................T
T..................................................................................................T
T.........................................................................TT.......................T
T.........................................................................TTT......................T
T.........................................................................TTT......................T
T.....................TTTTTTTTT....................................................................T
T.........................................TTTTTTTT.................................................T
T.........................................TTTTTTTT.................................................T
T.........................................TTTTTTTT.................................................T
T.........................................TTTTTTTT.................................................T
TTT.......................................TTTTTTTT................................................TT
TTT.......................................TTTTTTTT................................................TT
TTT.......................................TTTTTTTT................TTTT............................TT
TT........................................TTTTTTTT................TTT.............................TT
TT.................................................................................................T
TT.................................................................................................T
TT.................................................................................................T
TT.................................................................................................T
T...........................TTT....................................................................T
T............................TTTTTTTTT.............................................................T
T..........................TTTTTTTTT...............................................................T
TT.......................TTTTTTTTT.................................................................T
TTT......................TTTTTTT...................................................................T
TTT......................TTTTTT....................................................................T
TTT.......................TTTTT....................................................................T
T...........................TTT....................................................................T
TTT...........................TT..................................TTTT............TTTT............TT
TTT.............................TT................................TTTT............TTTT............TT
TTT..............................TT...............................TTTT............TTTT............TT
TT................................................................TTT.............TTT.............TT
T...........................TTT....................................................................T
T............................TTTTTTTTT.............................................................T
T..........................TTTTTTTTT...............................................................T
TT.......................TTTTTTTTT.................................................................T
TTT......................TTTTTTT...................................................................T
TTT......................TTTTTT....................................................................T
TTT.......................TTTTT....................................................................T
T...........................TTT....................................................................T
TTT...........................TT..................................TTTT............TTTT............TT
TTT.............................TT................................TTTT............TTTT............TT
TTT..............................TT...............................TTTT............TTTT............TT
T...........................TTT....................................................................T
T............................TTTTTTTTT.............................................................T
T..........................TTTTTTTTT...............................................................T
TT.......................TTTTTTTTT.................................................................T
TTT......................TTTTTTT...................................................................T
TTT......................TTTTTT....................................................................T
TTT.......................TTTTT....................................................................T
T...........................TTT....................................................................T
TTT...........................TT..................................TTTT............TTTT............TT
TTT.............................TT................................TTTT............TTTT............TT
TTT..............................TT...............................TTTT............TTTT............TT
T...........................TTT....................................................................T
T............................TTTTTTTTT.............................................................T
T..........................TTTTTTTTT...............................................................T
TT.......................TTTTTTTTT.................................................................T
TTT......................TTTTTTT...................................................................T
TTT......................TTTTTT....................................................................T
TTT.......................TTTTT....................................................................T
T...........................TTT....................................................................T
TTT...........................TT..................................TTTT............TTTT............TT
TTT.............................TT................................TTTT............TTTT............TT
TTT..............................TT...............................TTTT............TTTT............TT
T..................................................................................................T
T..................................................................................................T
T............................TT....................................................................T
T..........................TTTTTT..................................................................T
T......................TTTTTTTTTTTTTTTT............................................................T
T......................TTTTTTTTTT..................................................................T
T............................TTTTTTTTTTTTTT........................................................T
T..................................TTTTTTTT........................................................T
T.....................................TTTTT........................................................T
T......................................TTT.........................................................T
T.......................................TT.........................................................T
T......................................................................TTT...TTT...................T
T...........................TTT....................................................................T
T............................TTTTTTTTT.............................................................T
T..........................TTTTTTTTT...............................................................T
TT.......................TTTTTTTTT.................................................................T
TTT......................TTTTTTT...................................................................T
T............................TTTTTTTTT.............................................................T
T..........................TTTTTTTTT...............................................................T
TT.......................TTTTTTTTT.................................................................T
TTT......................TTTTTT....................................................................T
TTT.......................TTTTT....................................................................T
T...........................TTT....................................................................T
TTT...........................TT..................................TTTT............TTTT............TT
TTT.............................TT................................TTTT............TTTT............TT
TTT..............................TT...............................TTTT............TTTT............TT
TTT...............................................................TTTT.TTTT..TTTT.TTTT............TT
TTT...............................................................TTTT.TTTT..TTTT.TTTT............TT
TTT...............................................................TTTT.TTTT..TTTT.TTTT............TT
T..................................................................................................T
TTT...............................................................TTTT.TTTT..TTTT.TTTT............TT
TTTTTTTTTTTTTTTTTTTTTTTTTTTTTTTTTTTTTTTTTTTTTTTTTTTTTTTTTTTTTTTTTTTTTTTTTTTTTTTTTTTTTTTTTTTTTTTTTTTT