TTTTTTTTTTTTTTTTTTTT
TTT.................
TT..................
T.............TTTT..
T...................
T...................
T...................
T...................
T....TTTTTT.........
T....TTTTT..........
T....TTT............
T...................
T...................
T...................
T..........TTTT.....
T..........TTTTT....
T...................
T...................
T...................
T...............TTTT
