TTTTTTTTTTTTTTTTTTTTTTT.................
TTT.................TTT.................
TT..................TTT.................
T.............TTTT..TTT.................
T...................TTT.................
T...................TTT.................
T...................TTT.................
T...................TTT.................
T....TTTTTT.........T....TTTTTT.........
T....TTTTT..........T....TTTTTT.........
T....TTT............T....TTTTTT.........
T...................T...................
T.......................................
T.......................................
T..........TTTT.........................
T..........TTTTT........................
T.......................................
T.......................................
T.......................................
T...............TTTT....................
T.......................................
T.......................................
T..........TTTT.........................
T..........TTTTT........................
T.......................................
T.......................................
T.......................................
T...............TTTT....................
T.......................................
T.......................................
T..........TTTT.........................
T..........TTTTT........................
T.......................................
T.......................................
T.......................................
T...............TTTT....................
T...............TTTT....................
T...............TTTT....................
T...............TTTT....................
TTTTTTTTTTTTTTTTTTTTTTT.................