TTTTTTTTTTTTTTTTTTTTTTTTTTTTTTTTTTTTTTTTTTTTTTTTTT
TTT............TTTT.TTT...TTTT.TTTT............TTT
TT.............TTT........TTT..TTT.............TTT
T................................................T
T................................................T
T................................................T
T................................................T
T.......................TT.......................T
T.......................TTT......................T
T.......................TTT......................T
T................................................T
T................................................T
T................................................T
T................................................T
T................................................T
TTT.............TTTT............TTTT............TT
TTT.............TTTT............TTTT............TT
TTT.............TTTT............TTTT............TT
TT..............TTT.............TTT.............TT
TT...............................................T
TT...............................................T
TT...............................................T
TT...............................................T
T................................................T
T................................................T
T................................................T
TT...............................................T
TTT..............................................T
TTT..............................................T
TTT..............................................T
T................................................T
TTT.............TTTT............TTTT............TT
TTT.............TTTT............TTTT............TT
TTT.............TTTT............TTTT............TT
TT..............TTT.............TTT.............TT
T................................................T
T................................................T
T................................................T
T................................................T
T................................................T
T................................................T
T................................................T
T................................................T
T................................................T
T................................................T
T................................................T
T....................TTT...TTT...................T
TTT.............TTTT.TTTT..TTTT.TTTT............TT
T................................................T
TTTTTTTTTTTTTTTTTTTTTTTTTTTTTTTTTTTTTTTTTTTTTTTTTT